{
    "mapData":
    [
        {
            "tag": "Tips",
            "defs":{
                "1":{"color":[0.05,0.3,0.05,1],"height":1,"tag":"Cube", "yOffset": 0},
                "2":{"center":[true, true],"color":[0.5,0.5,0.5,1],"height":2.5,"tag":"Cone", "yOffset": 0},
                "3":{"color":[0.5,0.5,0.5,1],"high":1, "low": 0, "tag":"Slope", "highEdge": "ColumnMin", "yOffset": 0},
                "4":{"color":[0.5,0.5,0.5,1],"height":0.02,"tag":"Cube", "yOffset": 0},
                "5":{"color":[0.2,0.2,0.2,1],"height":0.02,"tag":"Cube", "yOffset": 0},
                "7":{"center":[true, true],"color":[0.5,0.5,0.5,1], "height": 1, "tag":"Cylinder","yOffset":0},
                "8":{"center":[false, true],"color":[0.5,0.5,0.5,1], "height": 1, "tag":"Cylinder","yOffset":0},
                "9":{
                    "tag":"Reference",
                    "contents": {
                        "tag": "External",
                        "contents": "tree.json" 
                    }
                }
            },
            "map":[
                [0,0,0,0,0,0,0,0,0,0,0,0,0,0,0,0,0,0,0,0,0,0,0,0,0,0,0,0,0,0,0,0,0,0,0,0,0,0,0,0],
                [0,1,0,0,0,0,0,0,0,0,0,0,0,0,0,0,0,0,0,0,0,1,0,0,0,0,0,0,0,0,0,0,0,0,0,0,0,0,0,0],
                [2,2,2,2,1,0,0,0,0,3,3,3,0,0,0,9,0,0,0,0,0,2,2,1,1,7,7,7,4,4,4,8,8,0,0,9,0,0,0,0],
                [2,2,2,2,0,0,0,0,0,3,3,3,0,0,0,0,0,0,0,0,0,2,2,0,0,7,7,7,4,4,4,4,4,0,0,0,0,0,0,0],
                [5,5,5,5,0,0,0,0,0,3,3,3,0,0,0,0,0,0,0,0,5,5,5,5,0,4,4,0,0,0,0,4,4,0,0,0,0,0,0,0],
                [0,7,7,0,0,0,0,0,0,0,0,0,0,0,0,0,0,0,0,0,0,7,7,0,0,4,4,0,0,0,0,3,3,0,0,0,0,0,0,0],
                [0,7,7,0,0,0,0,0,0,0,0,0,0,0,0,0,0,0,0,0,0,7,7,0,0,4,4,0,0,0,0,3,3,0,0,0,0,0,0,0],
                [0,0,0,0,0,0,0,0,0,0,0,0,0,0,0,0,0,0,0,0,0,0,0,0,0,4,4,0,0,0,0,3,3,0,0,0,0,0,0,0],
                [0,0,0,0,0,0,0,0,0,0,0,0,0,0,0,0,0,0,0,0,0,0,0,0,0,4,4,0,0,0,0,0,0,3,3,0,0,0,0,0],
                [0,0,0,0,0,0,0,0,0,0,0,0,0,0,0,0,0,0,0,0,0,0,0,0,0,4,4,0,0,0,0,0,0,3,3,0,0,0,0,0],
                [0,0,0,0,0,0,0,0,0,0,0,0,0,0,0,0,0,0,0,0,0,0,0,0,0,4,4,0,0,0,0,0,0,3,3,0,0,0,0,0],
                [0,1,0,0,0,4,4,4,4,4,4,4,4,4,4,4,0,0,0,0,0,1,0,0,0,4,4,4,4,4,4,4,4,4,0,0,0,0,0,0],
                [0,2,2,1,1,4,4,4,4,4,4,4,4,4,4,4,0,0,0,0,0,2,2,1,1,4,4,4,4,4,4,4,4,4,0,0,0,0,0,0],
                [0,2,2,0,0,4,4,4,4,4,4,4,4,4,4,4,0,0,0,0,0,2,2,0,0,4,4,0,0,9,9,9,9,0,0,0,0,0,0,0],
                [0,0,0,0,0,4,4,4,4,4,4,4,4,4,4,4,0,0,0,0,0,0,0,0,0,4,4,0,0,9,9,9,9,0,0,0,0,0,0,0],
                [0,0,0,0,0,4,4,4,4,0,0,0,0,0,0,0,0,0,0,0,0,0,0,0,0,4,4,0,0,9,9,9,9,0,0,0,0,0,0,0],
                [0,0,0,0,0,4,4,4,4,0,0,0,0,0,0,0,0,0,0,0,0,0,0,0,0,4,4,0,0,9,9,9,9,0,0,0,0,0,0,0],
                [0,0,0,0,0,4,4,4,4,0,0,0,0,0,0,0,0,0,0,0,0,0,0,0,0,4,4,0,0,0,0,0,0,0,0,0,0,0,0,0],
                [0,0,0,0,0,4,4,4,4,0,0,0,0,0,0,0,0,0,0,0,0,0,0,0,0,4,4,0,0,0,0,0,0,0,0,0,0,0,0,0],
                [0,0,0,0,0,4,4,4,4,0,0,0,0,0,0,0,0,0,0,0,0,0,0,0,0,4,4,0,0,0,0,0,0,0,0,0,0,0,0,0],
                [0,0,0,0,0,4,4,4,4,0,0,0,0,0,0,0,0,0,0,0,0,0,0,0,0,0,0,0,0,0,0,0,0,0,0,0,0,0,0,0],
                [0,1,0,0,0,4,4,4,4,0,0,0,0,0,0,0,0,0,0,0,0,1,0,0,0,0,0,0,0,0,0,0,0,0,0,0,0,0,0,0],
                [0,2,2,1,1,4,4,4,4,4,4,8,8,0,0,9,0,0,0,0,0,2,2,1,1,7,7,7,4,4,4,8,8,0,0,9,0,0,0,0],
                [0,2,2,0,0,4,4,4,4,4,4,4,4,0,0,0,0,0,0,0,0,2,2,0,0,7,7,7,4,4,4,4,4,0,0,0,0,0,0,0],
                [5,5,5,5,0,4,4,4,4,0,0,4,4,0,0,0,0,0,0,0,5,5,5,5,0,4,4,0,0,0,0,4,4,0,0,0,0,0,0,0],
                [0,7,7,0,0,4,4,4,4,0,0,3,3,0,0,0,0,0,0,0,0,7,7,0,0,4,4,0,0,0,0,3,3,0,0,0,0,0,0,0],
                [0,7,7,0,0,4,4,4,4,0,0,3,3,0,0,0,0,0,0,0,0,7,7,0,0,4,4,0,0,0,0,3,3,0,0,0,0,0,0,0],
                [0,0,0,0,0,4,4,4,4,0,0,3,3,0,0,0,0,0,0,0,0,0,0,0,0,4,4,0,0,0,0,3,3,0,0,0,0,0,0,0],
                [0,0,0,0,0,4,4,4,4,0,0,0,0,3,3,0,0,0,0,0,0,0,0,0,0,4,4,0,0,0,0,0,0,3,3,0,0,0,0,0],
                [0,0,0,0,0,4,4,4,4,0,0,0,0,3,3,0,0,0,0,0,0,0,0,0,0,4,4,0,0,0,0,0,0,3,3,0,0,0,0,0],
                [0,0,0,0,0,4,4,4,4,0,0,0,0,3,3,0,0,0,0,0,0,0,0,0,0,4,4,0,0,0,0,0,0,3,3,0,0,0,0,0],
                [0,1,0,0,0,4,4,4,4,4,4,4,4,4,0,0,0,0,0,0,0,1,0,0,0,4,4,4,4,4,4,4,4,4,0,0,0,0,0,0],
                [0,2,2,1,1,4,4,4,4,4,4,4,4,4,0,0,0,0,0,0,0,2,2,1,1,4,4,4,4,4,4,4,4,4,0,0,0,0,0,0],
                [0,2,2,0,0,4,4,4,4,9,9,9,9,0,0,0,0,0,0,0,0,2,2,0,0,4,4,0,0,9,9,9,9,0,0,0,0,0,0,0],
                [0,0,0,0,0,4,4,4,4,9,9,9,9,0,0,0,0,0,0,0,0,0,0,0,0,4,4,0,0,9,9,9,9,0,0,0,0,0,0,0],
                [0,0,0,0,0,4,4,4,4,9,9,9,9,0,0,0,0,0,0,0,0,0,0,0,0,4,4,0,0,9,9,9,9,0,0,0,0,0,0,0],
                [0,0,0,0,0,4,4,4,4,9,9,9,9,0,0,0,0,0,0,0,0,0,0,0,0,4,4,0,0,9,9,9,9,0,0,0,0,0,0,0],
                [0,0,0,0,0,4,4,4,4,0,0,0,0,0,0,0,0,0,0,0,0,0,0,0,0,4,4,0,0,0,0,0,0,0,0,0,0,0,0,0],
                [0,0,0,0,0,4,4,4,4,0,0,0,0,0,0,0,0,0,0,0,0,0,0,0,0,4,4,0,0,0,0,0,0,0,0,0,0,0,0,0],
                [0,0,0,0,0,4,4,4,4,0,0,0,0,0,0,0,0,0,0,0,0,0,0,0,0,4,4,0,0,0,0,0,0,0,0,0,0,0,0,0]

            ]
        },
        {
            "tag": "Fill",
            "contents": {
                "color":[0.2,0.4,0.2,0.75],"height":0.01,"tag":"Cube", "yOffset": 0
            }
        }
    ],
    "size":[40,40]
}