{
    "size":[20,20],
    "mapData":
    [
        {
            "tag": "Tips",
            "defs":{
                "1":{"color":[255,127,127,255],"high":2.0, "low": 0, "tag":"Slope", "highEdge": ["Y", false],  "yOffset": -2},
                "2":{"color":[127,127,127,255],"height":0.1,"tag":"Cube", "yOffset": -2.6},
                "3":{"color":[127,127,127,255],"high":2.0, "low": 0, "tag":"Slope", "highEdge": ["Y", false], "yOffset": -2.0},
                "4":{"color":[127,127,127,255],"high":2.0, "low": 0, "tag":"Slope", "highEdge": ["X", false], "yOffset": 0},
                "5":{"color":[127,127,127,255],"height":2.0,"tag":"Cube", "yOffset": -2},
                "6":{"color":[ 30,100, 30,255],"height":0.1,"tag":"Cube", "yOffset": 0},
                "7":{"color":[ 127,127, 127,255],"height":0,"tag":"Cube", "yOffset": -2},
                "8":{"color":[127,127,127,255],"high":1, "low": 0, "tag":"Slope", "highEdge": ["X", true], "yOffset": 0},
                "9":{"color":[127,127,127,255],"high":0.55, "low": 0, "tag":"Tetra", "edge": [true, true], "yOffset": 0}
           },
            "maps":[
                [
                    [0,0,0,0,0,0,0,0,0,0,0,0,0,0,0,0,0,0,0,0],
                    [0,0,0,0,0,0,0,0,0,0,0,0,0,0,0,0,0,0,0,0],
                    [0,0,0,0,0,0,0,0,0,0,0,0,0,0,0,0,0,0,0,0],
                    [5,5,5,5,5,5,5,5,5,5,5,5,5,5,5,5,5,5,5,5],
                    [5,5,5,5,5,5,5,5,5,5,5,5,5,5,5,5,5,5,5,5],
                    [5,5,5,5,5,5,5,5,5,5,5,5,5,5,5,5,5,5,5,5],
                    [4,4,4,4,4,4,4,4,4,1,1,1,1,1,1,1,1,1,1,1],
                    [4,4,4,4,4,4,4,4,4,1,1,1,1,1,1,1,1,1,1,1],
                    [4,4,4,4,4,4,4,4,4,1,1,1,1,1,1,1,1,1,1,1],
                    [4,4,4,4,4,4,4,4,4,1,1,1,1,1,1,1,1,1,1,1],
                    [4,4,4,4,4,4,4,4,4,1,1,1,1,1,1,1,1,1,1,1],
                    [1,1,1,1,4,4,4,4,4,1,1,1,1,1,1,1,1,1,1,1],
                    [1,1,1,1,4,4,4,4,4,1,1,1,1,1,1,1,1,1,1,1],
                    [1,1,1,1,1,1,1,1,0,1,1,1,1,1,1,1,1,1,1,1],
                    [1,1,1,1,1,1,1,1,0,1,1,1,1,1,1,1,1,1,1,1],
                    [1,1,1,1,1,1,1,1,0,7,7,7,7,7,7,7,0,0,0,0],
                    [1,1,1,1,1,1,1,1,0,7,7,7,7,7,7,7,0,0,0,0],
                    [1,1,1,1,1,1,1,1,0,7,7,7,7,7,7,7,0,0,0,0],
                    [1,1,1,1,1,1,1,1,0,7,7,7,7,7,7,7,0,0,0,0],
                    [1,1,1,1,1,1,1,1,0,7,7,7,7,7,7,7,0,0,0,0]
                ]
            ]
        }
    ]
}
